11111111111111111111
10010000000000000C01
10000111010001111111
1P001101000000000001
11111111111111111111
