111111111111111111111111111111
1000000011110000000000C0000001
10000C0000000000000000000000E1
100000000000111111000000000111
100000000001111111111110000001
100111000000110000000000000001
1000C0000000000000000000000001
1000000P0000000000000000000001
100000111100000000011100000001
100C00000111111100010100011101
100000000000000000011100001001
1111111111000000C0000000010101
111111111000000000000000010101
110001111111000C00000000010101
111111111111111111111111111111