111111111111111111111111111111
1000000000000000000000C0000001
10000C0000000000000000000000E1
100000000000000000000000000001
100000000000000000000000000001
100000000000000000000000000001
1000C0000000000000000000000001
1000000P0000000000000000000001
100000000000000000000000000001
100C00000000000000000000000001
100000000000000000000000000001
1000000000000000C0000000000001
100000000000000000000000000001
100000000000000C00000000000001
111111111111111111111111111111