11111111111111111111
10010000000001000C01
10000111010001111111
1P001101000000E00001
11111111111111111111