11111111111111111111
10010000000001000001
10000111010001111111
1P0011010000000E0001
11111111111111111111
