11111111111111111111
100100000E0000000C01
10000111010001110001
1P001101000000CEC001
11111111111111111111