00000000000000000000
00000010000100000C00
00001010010000000000
0P000000000000CEC000
00000000000000000000
