11111111111111111111
10010000000000000C1
10000111010001110001
1P001101000000CEC0011
11111111111111111111