11111111111111111111
1CCCCCCCCCCCCCCCCCC1
1CCCCCCCCCCCCCCCCCC1
1PCCCCCCCCCCCCCECCC1
11111111111111111111
